1111111111111111111111111111
1222222222222222222222222221
1200000000000000000000000021
1200000000000000000000000021
1200000000000000000000000021
1200000000000000000000000021
1200000000000000000000000021
1200000000000000000000000021
1200000000000000000000000021
1200000000000000000000000021
1200000000000000000000000021
1200000000000000000000000021
1200000000000000000000000021
1200000000000000000000000021
1200000000000000000000000021
1200000000000000000000000021
1200000000000000000000000021
1200000000000000000000000021
1200000000000000000000000021
1200000000000000000000000021
1200000000000000000000000021
1200000000000000000000000021
1200000000000000000000000021
1200000000000000000000000021
1200000000000000000000000021
1200000000000000000000000021
1200000000000000000000000021
1200000000000000000000000021
1200000000000000000000000021
1222222222222222222222222221
1111111111111111111111111111