1111111111111111111111111111111111111111XXXXXXXXXXXXXXX
100000000000000000E100000000000000000001XXXXXXXXXXXXXXX
1011111111111111010101111111111111111101XXXXXXXXXXXXXXX
1010000000000000010100000000000000000101XXXXXXXXXXXXXXX
1010111111111111110111111111111111110101XXXXXXXXXXXXXXX
1010100000000000000100000000000000010101XXXXXXXXXXXXXXX
1010101011111111111101011111111111010101XXXXXXXXXXXXXXX
1010101010000000000101010000000001010101XXXXXXXXXXXXXXX
1010101010111111110101010111111101010101XXXXXXXXXXXXXXX
1010101010100000010101010000000101010101XXXXXXXXXXXXXXX
1010101010101111010101011111110101010101XXXXXXXXXXXXXXX
1010101010101000010101000000010101010101XXXXXXXXXXXXXXX
1010101010101011110101111111010101010101XXXXXXXXXXXXXXX
1010101010001010000000000001010101010101XXXXXXXXXXXXXXX
1010101011111010111111111101010101010101XXXXXXXXXXXXXXX
1000101000000010000000000000010101000101XXXXXXXXXXXXXXX
1010101111111110111001110101110101111101XXXXXXXXXXXXXXX
1010101000000000111001110101000100000001XXXXXXXXXXXXXXX
1010101011111010111001110101011101110101XXXXXXXXXXXXXXX
1010101010000010111001110101000101010101XXXXXXXXXXXXXXX
1010101010111110111001110101110101010101XXXXXXXXXXXXXXX
1010101010100010000000000100010101010101XXXXXXXXXXXXXXX
1010101000101010111001110001010101010101XXXXXXXXXXXXXXX
1010101111101010111001110101010101010101XXXXXXXXXXXXXXX
1000100000001010111001110100010101000101XXXXXXXXXXXXXXX
1011111111111010000000000101110101111101XXXXXXXXXXXXXXX
1E00100000000010111001110101000100000001XXXXXXXXXXXXXXX
1010101111111110111001110101011111111111XXXXXXXXXXXXXXX
10100010000000101110011101010000000000E1XXXXXXXXXXXXXXX
1010101011111000000000000001111111111101XXXXXXXXXXXXXXX
1010101010001010111001110101000000010001XXXXXXXXXXXXXXX
1010101010101010111001110101011111010101XXXXXXXXXXXXXXX
1010101010101010111001110101010001010101XXXXXXXXXXXXXXX
1010101010101010000000000100010101010101XXXXXXXXXXXXXXX
1010101010101010111001110101010101010101XXXXXXXXXXXXXXX
1010101010000010111001110101000101010101XXXXXXXXXXXXXXX
1010101011111010111001110101111101010101XXXXXXXXXXXXXXX
1010101000000000111001110100000001010101XXXXXXXXXXXXXXX
1010001111111110111001110101111111010101XXXXXXXXXXXXXXX
1010111000000000000000000000000000010101XXXXXXXXXXXXXXX
1000001011111011111111111101111111110101XXXXXXXXXXXXXXX
1010101011111000000000000001000000000001XXXXXXXXXXXXXXX
1010101010001111111111111111011111010101XXXXXXXXXXXXXXX
1010101010100000010000100000010001010101XXXXXXXXXXXXXXX
1010101010111111010110101111110101010101XXXXXXXXXXXXXXX
1010101010000101010110100000000101010101XXXXXXXXXXXXXXX
1010101011111101010110111111111101010101XXXXXXXXXXXXXXX
1010101000000001010110000000000001010101XXXXXXXXXXXXXXX
1010101111111111010110111111111111010101XXXXXXXXXXXXXXX
10101000000000000101100000000000000101E1XXXXXXXXXXXXXXX
1010111111111111111111111111111111110101XXXXXXXXXXXXXXX
1010000000000000001001000000000000000101XXXXXXXXXXXXXXX
1011111111111111101001011111111111111101XXXXXXXXXXXXXXX
1000000000000000000P00000000000000000001XXXXXXXXXXXXXXX
1111111111111111111111111111111111111111XXXXXXXXXXXXXXX

